 ##########                  ########  +-----------------------------+  
 # +------#-+             +--#---+  #  |.............................|  
 # |........|             |......|  #  |.............................|  
 # |........|     +-------+......|  ####.............................|  
 # |........|     |..............|     +--------------#-----+........|  
 # +---#----+     |..............+-------------+      #     |........|  
 #     #          |............................|      #     |........|  
 #     #    +-----+............................########     +--+..+--+  
 #     #    |..................................|               |..|     
 #     ######..................................+------------+  |..|     
 #          |............+----------------+.................|  |..|     
 #          |............|                |.................|  |..|     
 #   +------+............|                |..............+--+  |..|     
 #   |...................|     +----+     |......+-------+  ####..|     
 #   |...................|     |....|     |......|  #########  |..|     
 #   |...................|     |....|     |......|  #    +-----+..|     
 #   +------------+......+-----+....+-----+......|  #    |........|     
 #                |..............................|  #    |........|     
 #   +------------+...........................+--+  #    +--------+     
 #   |........................................|     #                   
 #   |........................................|     #######             
 #   |.....+-----------+..........+-------+...+--+        #####         
 #   |.....|  +-----+  |..........|       |......|            #         
 #   +-#---+  |.....|  |..........#####   |......|            #         
 #     #      |.....####..........|   #   +---+..+-------+    #         
 #     # +----+.....|  |..........|   #       |..........|    #         
 #     ###..........|  +----------+   #       +---+......|    #         
 #       +----------+                 #           |......######         
 ######################################           +------+              
                                                                        
