    #################################################################   
    #   +-----------+----------+--------------+-------------+-------#--+
#########...........|..........|..............|.............|..........|
#   #   +--------+.-+..........+............. |.............|..........|
#   #   |.................................... |.............|..........|
#   #   +------------+.........+............. |.............+.+--------+
#   #   |............|.........|............. |........................|
#   #   |......+-----+.........|..............|........................|
#   #   +-+.+--+...............+-----+..+-----+........................|
#   #   |...............................................+---+.+--------+
#   #   +.+--------+........+--------------------+......|..............|
#   #   |..........|........|                    |......+..............|
#   #   |..........+........|                    |.....................|
#   #   |...................|                    |......+..............|
#   #   |..........+........|                    |......|..............|
#   #   |..........|........|                    |......+-------+......|
#   #   +----------+........|                    |..............|......|
#   #   |...................+--------------------+..............+------+
#   #   +--------+.....................................................|
#   #   |........|.....................................................|
#   #   |........+..........+---+.+-------+.+--+.......................|
#   #   |...................|..................|.........+-+.+---------+
#   #   |........+--+.......|..................|.........|.............|
#   #   |...........|.......|..................|.........|.............|
#   #   |...........|.......+----+........+----+.........|.............|
#   #   |...........|............|........|..............|.............|
#   #   +--#--------+------------+--------+--------------+-----------#-+
#   ########                                                         #  
#                                                                    #  
######################################################################   
