+------------+                                    
|............|              +----------------+    
|............########       |................|    
|............|      #       |..........+-----+    
|............|      #########..........|          
|............|      #       |..........|          
|............+------#----+  +----#-----+          
|........................|       #                
|........................|       #                
|........................|       #  +---------+   
+--#---------------------+       #  |.........|   
   #                             #  |.........|   
+--#------------------+          #  +-------#-+   
|.....................############          #     
|.....................|          #          #     
|.....................|          #          #     
|.....................|          ########   #     
|.....................|                 #   #     
+-------#-------------+                 #####     
        #                               #         
        #                               #         
        #################################         
                      #                           
+---------------------#------------------------+  
|..............................................|  
|..............................................|  
|..............................................|  
+----------------------------------------------+  
