                                          +-#-+                         
                                          |...|                         
                                    +-----+...+-----+                   
  +------------+   +------------+   |...............|   +----+  +----+  
  |............|   |............#####....+--#--+....|   |....|  |....|  
  |....+-------+   |....+--+....|   |....|  #  +----+   |....|  |....|  
  |....|           |....|  |....|   |....+--#-------+   |....+--+....|  
###....|           |....+--+....|   |...............|   |............###
  |....|           |............|   +-------#--+....|   |....+--+....|  
  |....+-------+   |....+--+....|   +----+  #  |....|   |....|  |....|  
  |............#####....|  |....|   |....+--#--+....#####....|  |....|  
  +------------+   +----+  +----+   |...............|   +----+  +----+  
                                    +-----+...+-----+                   
                                          |...|                         
                                          +-#-+                         
