                                                                 
    +-------------+                  +----------------------+    
    |.............|                  |......................|    
    |....+---+....|         ##########......................|    
    |....|   |....|         #        |......................|    
    |....+---+....|         #        |......................|    
    |.............|         #        |......................|    
    |.............################   +-------#--------------+    
    |....+---+....|        #                 #                   
    |....|   |....|        #                 #                   
    |....+---+....|        #                 ##########          
    |.............|        #                          #          
    +--------#----+        #                 +--------#---------+
             #             #                 |..................|
             #################################..................|
             #         #                     |..................|
             #         #      +------+       |..................|
             #         ###### |......|       |..................|
             #         #    ###......|       |..................|
             ###########      |......|       |..................|
                       #      |......|       |..................|
                       #      +------+       +------------------+
                       #                                         
        +--------------#----------------------------+            
        |...........................................|            
        |...........................................|            
        |...........................................|            
        |.............+-----------------+...........|            
        |.............|                 |...........|            
        |.............|            +----+...........|            
        |.............|            |................|            
        |.............|   +--------+................|            
        |.............|   |.........................|            
        +-------------+   |.........................|            
                          +-------------------------+            
