                                                                                                                            
           +------------------+                                                                                             
           |..................|                                                                                             
           |..................|                                                                                             
           |..................|                                                                                             
           |..................|                                   +-------------------------------------+                   
           |.......+-----+....|                                   |.....................................|                   
           |.......|     |....|            +---------+            |................+-----------+........|                   
           |.......|     |....|            |.........|            |................|           |........|                   
           |.......+-----+....|            |.........|            |................+-----------+........|                   
           |..................##############.........##############.....................................|                   
           +------------------+            +----#----+            +-------------------------------------+                   
                                                #                                                                           
     +---------------------------------+        #                                                                           
     |.................................|        #                                                                           
     |.................................|        #                                                                           
     |......+---------------+..........|        #                                                                           
     |......|               |..........##########                                                                           
     |......|               |..........|        #                                                                           
     |......+---------------+..........|        #                                                                           
     |.................................|        #                                                                           
     +---------------------------------+        #                                                                           
                                           +----#----+            +------------------+                                      
                                           |.........##############..................|                                      
                                           |.........|            |..................|                                      
                                           |.........|            |..................|                                      
                                           +---------+            |..................|                                      
                                                                  |..................|                                      
                                                                  |..................|                                      
                                                                  |..................|                                      
                                                                  |..................|                                      
                                                                  |..................|                                      
                                                                  |..................|                                      
                                                                  |..................|                                      
                                                                  |..................|                                      
                                                                  |..................|                                      
                                                                  |..................|                                      
                                                                  |..................|                                      
                                                                  |..................|                                      
                                                                  +------------------+                                      
