 +----------------------------+                                      
 |............................|                                      
 |...+-----+..................|               +-------+              
 |...|     |...+-------+......|               |.......|              
 |...|     |...|       |......+-----+         |.......|              
 +---+     |...|       |............###########.......|              
           +-#-+       |............|         |.......|              
             #         |......+-----+         |.......|      +-----+ 
             #         |......|               |.......|      |.....| 
      +------#---------+......|               |.......|      |.....| 
      |.......................|               |.......|      |.....++
      |.......................#########       |.......+------+......|
      +---------#-------------+       #       |.....................|
                #                     #########.....................|
                #                             +---------------------+
      +---------#--------+                                           
      |..................|                                           
      |......+----+......|                                           
      |......|    |......|                                           
      |......|    |......|                                           
      |......+----+......|                                           
      |..................|                                           
      |.............+----+                                           
      |.............|                                                
      |.....+----+..+-+                                              
      |.....|    |....|                                              
      |.....|    +-+..+-+                                            
      |.....|      |....|                                            
      |.....|      +-+..+-+                                          
      |.....|        |....|                                          
      |.....|        +-+..+-+                                        
      |.....|          |....|                                        
      +-----+          +----+                                        
