+---+ +---+                                 
|...| |...| ########  +-----+               
|...+-+...+-#---+  #  |.....|               
|...............|  #  |.+--#+ +--------+    
+---+...........|  ####.|  ## |........###  
    |.....+--#--+     |.|  +#-+......+-+ #  
    |.....|  #        +-+  |.........|   #  
    |.....|  #########     +-------#-+  +#-+
  +-+.....|          #             #    |..|
  |....+--+          #            +#-+ ##..|
  |....|             #            |..|##+--+
  |....###### +--+   ###########  +--+      
  +----+ #  # |..|             #            
         #  ###..##      +--+  ###########  
         #    +--+#      |..|            #  
         #        #      |..|            #  
         #        #  +---+..+--+         #  
         #  +--+  #  |.........|         #  
         ####..|  #  |.........|         #  
            |..|  #  |.........| #####   #  
            |..#######.........+-#-+ #   #  
            |..|  #  |.............| #   #  
        +---+..|  #  +---+...+-----+ #   #  
        |......|  #      |...|      +#---#-+
        +------+         +---+      |......|
                                    +------+
