                                                                                                   
 +-------------+                                                                                   
 |.............|        +------------+                                                             
 |.............|        |............|                                                             
 |.............######   |............|             +-------------------------------------+         
 |.............|    #   |............+---+         |.....................................|         
 +-------------+    #####................|         |.....................................|         
                        |................+---  #####..........................+----------+         
      +-+               |...................|  #   |..........................|                    
#######.|               |...................####   +--------------------+.....####                 
      |.|               +----#--------------+                           |.....|  ##                
      |.|   +---------+      #                                          +-----+   #################
      +#+   |.........|      #       +--------------------------------+                      #     
       ######.........############## |................................|                      #     
          # |.........|            # |................................|     +-------------+  #     
          # +---------+            ###................................|     |.............|  #     
        # #                          |................................|     |.............####     
        #                            |................................|     |.............|        
        #                            |................................|     |.............|        
        ##################           |........+----+..................|     +-#-----------+        
                         #           |........|    |..................|       #                    
        ##################           |........|    |.....+------------+   #####                    
        #                            |........|    |.....|                #                        
        ##############################........|    |.....##################                        
             #                       |........+----+.....|                #   +-------------------+
             #                       |...................+--------+       #   |...................|
             #                       +--+.........................|       #####...................|
             #                          |.........................|           |...................|
             #                          |.........................|           |...................|
             #                          +-------------------------+           +-------------------+
