      +--------------+             +--------------+ 
      |..............|             |..............| 
      |..............###############..............| 
      |..............|             |..............| 
      +--------------+             +--#-------#---+ 
                                      #       #     
                    ###########################     
                    #                 #    +--#----+
             +------#--------+        #    |.......|
             |...............|        #    +-----#-+
             |...............|        #          #  
             |...............|        #          ## 
             |.......+-----+.|        #           # 
             |.......|     |.###################  # 
             |.......|     |.|                 #  # 
             |.....+-+  +--+.|                 #  # 
             |.....|    |....|                 #  # 
             |.....|    |....|                 #  # 
             |.....|    |....|                 #  # 
             |.....+----+....|                 #  # 
             |...............|                 #  # 
             |...............|                 #  # 
             |...............|                 #  # 
             +---------------+                    # 
                                                  # 
  +---------------------+                         # 
  |.....................|                         # 
  |.....................########################### 
  |.....................|                           
  |.....................|                           
  |.....................|                           
  +---------------------+                           
