                                                                               
     +-----+              #############        +-----------------------+       
     |.....################           #        |.......................|       
     |.....| #       +----#----+   +--#--+     |.......................|       
     |.....| #       |.........|   |.....|     |...........+-----+.....|       
     |.....| #       |.........|   |.....#######...........|.....|.....|       
     |.....| #       |.........|   |.....|     |...........|.....#.....|       
     +--#--+ #       |.........|   +-----+     |...........|.....|.....|       
  #######    #       |.........#################...........+--#--+.....|       
  #          #       |.........|   +-----+     |...........|.....|.....|       
+-#-+   +----#-+     |.........|   |.....|     |...........|.....|.....|       
|...|   |......|     |.........|   |.....|     |...........|.....|.....|       
|...|   |......#######.........|   |.....|     +-----------+.....+-----+       
|...|   +----#-+     |.........#####.....|                 |.....|             
|...|        #       |.........|   |.....|                 |.....|             
|...|        #       +-------#-+   |.....|         #####   |.....|             
|...+--------#-----+         #     +-----+         #   #####.....|             
|..................|   ###+--#--+                  #       |.....|             
|..................### # ##.....#####  ### ### #####       +-----+             
|..................| ###  +-----+   #### ### ###                               
+------------------+                                                           
