          +----------------------+                          
          |......................|                          
          |......................|                          
          |......................|                          
          |......................|                          
          |......................|                          
          |......................|                          
          +-----------#----------+                          
                      #                                     
    ####################################                    
    #     #           #       #        #                    
    #     #           #       ##########                    
    ############      #       #      #                      
               ########     #####    ###################### 
       #########      #    ##   ##   #           #        # 
    ####       ########   ##     ##  #           #        # 
    #  #########      #####       ######         #        # 
    #      #                           #         #        # 
    ####################################         ########## 
                      #                              #      
           +----------#-----------+                 ###     
           |......................|                ## ##    
           |......................|               ##   ##   
           |......................|              ##     ##  
           |......................|             ##       ## 
           |......................|              ##     ##  
           |......................|               ##   ##   
           +----------------------+                ## ##    
                                                    ###     
                                                     #      
