+-------------+                      +---------------+
|.............|                      |...............|
|.............####               #####...............|
|.............|  #               #   |...............|
+-------------+  #               #   +---------#-----+
         +-------#---------------#-------+     #      
         |...............................|     #      
         |........+--------------+.......|     #      
     #####........|              |.......#######      
         |........|              |.......|     #      
         |........+--------------+.......|     #      
         |...............................|            
         +------#---------------#--------+            
                #################                     
                    #         #                       
                    #         #                       
               ######         ######                  
               #                   #                  
         +-----#---------------+  +#------------+     
         |.....................|  |.............|     
         |.....................|  |.............|     
         +-------------------#-+  |.............|     
                             #    |.............|     
                             ######.............|     
                                  +-------------+     
