  +-------+                                                                    
  |.......|                                                                    
  |.......+---+                                +-------+                       
  |...........############           ###########.......|                       
  +------#--#-+          #           #         +----#--+                       
         #  #            #           #              #                          
         #  #            #           #     +--------#+        #                
         #  #############################  |.........|        #                
         #            #          #       # |.........|        #                
         #            #          #      ####.........|        #                
         #            #          #         +----#----+        #                
         #            #          #              #    +--------#--+             
     +---#--------+  +#----------#-----+        #    |...........|             
     |............####.................|        ######...........|             
     |............|  |.................|        #    |...........|             
     |............|  |..+----+.........|        #    |...........|             
     |............|  |..|    |.........##########    +----#------+             
     |............|  |..+----+.........|                  #                    
     |............####.................####################                    
     |............|  |.................|                                       
     +------------+  +-----------------+                                       
