                                                                                                                                                    
                                                                                                                                                    
                                                                                                            ##################################      
      +--------------------+      +-------+    +-------+      +--------------------+      +-----------------#--+      +--------------------+ #      
      |....................|      |.......|    |.......########....................|      |....................|      |....................| #      
      |....................|      |.......|    |.......|      |....................|      |....................|      |....................| #      
      |......+-------------+      |.......|    |.......|      |......+-------------+      |......+-------------+      |.......+------+.....| #      
      |......|                    |.......|    |.......|      |......|                    |......|                    |.......##    ##.....| #      
      |......|                    |.......|    |.......|      |......|                    |......|                    |.......|      |.....| #      
      |......+-------------+      |.......+----+.......|      |......+-------------+      |......+-------------+      |.......+------+.....| #      
      |....................|      |....................|      |....................|   ####....................|      |....................| #      
      |....................|      |....................|      |....................#####  |....................|      |....................| #      
      +-------------+......|      |.......+----+.......|      |......+-------------+      |......+-------------+      |.......+-----#------+ #      
                    |......|      |.......|    |.......|      |......|                    |......|                    |.......|     ##########      
                    |......|      |.......|    |.......|      |......|                    |......|                    |.......|                     
      +-------------+......|      |.......######.......|      |......+-------------+      |......+-------------+      |.......|                     
      |....................|      |.......| ## |.......|      |....................|      |....................|      |.......|                     
      |....................########.......| ## |.......|      |....................|      |....................|      |.......|                     
      +----------#---------+      +-------+ ## +-------+      +-----------#--------+      +-------------#------+      +----#--+                     
                 #                         ####                          ###                           ###                 #                        
                 ###########################  ############################ ############################# ###################                        
