+------+                    +----+ ######          +---------+     ##   +-----+
|......| #####  ####        |....###    #          |.........|      #   |.....|
|......###   ####  #####    |....###    #          |.........|      #   |.....|
|......|            #  #    +-#--+ ######          |.........+---+  #   |.....|
+#-----+       ######### ###  #                    |.............|  #   +--#--+
 #             #         # #  #                    |.............|  ###    #   
 #             ########### ####                +---+.............|    ###  #   
 # +------------#+     +------+ +-+ +-+ +-+    |...............+-+      ####   
 # |.............|     |......| |.| |.| |.| +--+...+---+.......+-----+     ####
 # |.............|     |......| |.| |.###.| |......|   |.............+-+   #   
 # |.............|     |......| |.| |.| |.| |...+--+   +-----+.........+-+ ####
 # +-----------+.|     |......| |.###.| |.| |...|            |...........| #   
 # +-----------+.+-----+......| |.| |.| |.| |...|            |...........| #   
 # |..........................+-+.+-+.+-+.| |...|            |...........| #   
 # |......................................+-+...+------------+...........| #   
 # +----------------------------+.+-+.+-+................................| #   
 #      +-+  ###   +-+  ###     |.| |.###................................| #   
 # +-+  |.####+#+  |.####+#+    |.##|.| +-+----------------------#-------+ #   
 # |.|  +#+   |.## +#+   |.|    |.| |.###.|    #####  ########   #    #### #   
 # +#+  +#+   +-+#  #    +#+    |.+-+.| |.| +--#---#--#----+ #   #    #  # #   
 #  #####.|   |.#################.....| +-+ |..............###   #    #  # #   
 #      +-+   |.|               |.....###.| +------#-------+ #####    #  # #   
 # #### ###   +-+   ####  ###   +--+--+ +-+                           #  ######
 ###  ### ###########  #### ###########################################       #
