  +----------+                                                                   +----------+                                                     
  |..........|                 +---------+                                       |..........|                 +---------+                         
  |..........####              |.........|                +-------+      #########..........|                 |.........|                +-------+
  |..........|                 +-----#---+                |.......########       |..........|                 +-----#---+                |.......|
  +---------#+                       #              #######.......|              +---------#+                       #              #######.......|
            #                        #              #     +---#---+                        #                        #              #     +---#---+
            #  +-----------+         #     +--------#+        #                            #  +-----------+         #     +--------#+        #    
            ####...........##############  |.........|        #                            ####...........##############  |.........|        #    
               |...........|            #  |.........|        ##############################  |...........|            #  |.........|        #    
               +-----------+            ####.........|        #                               +-----------+            ####.........|        #    
                                           +----#----+        #                                                           +----#----+        #    
                                                #    +--------#--+                                                             #    +--------#--+ 
     +---------------------------------+        #    |...........|                  +---------------------------------+        #    |...........| 
     |.................................|        ######...........|                  |.................................|        ######...........| 
     |.................................|        #    |...........|                  |.................................|        #    |...........| 
     |......+---#-----------+..........|        #    |...........####################......+---------------+..........|        #    |...........| 
     |......|   #           |..........##########    +-----------+         #        |......|               |..........##########    +-----------+ 
     |......|   #           |..........|                                   #        |......|               |..........|     #                     
     |......|   #           |..........|                                   #        |......+---------------+..........|     #                     
     |......|   #           |..........|                                   #        |.................................|     #                     
     +------+   #           +----------+                                   #        +---------------------------------+     #                     
  +----------+  #                                                          #     +----------+                               #                     
  |..........|  #              +---------+                               #########..........|                 +---------+   #                     
  |..........####              |.........|                +-------+      #       |..........####              |.........#####            +-------+
  |..........|                 +-----#---+                |.......########       |..........|                 +-----#---+                |.......|
  +---------#+                       #              #######.......|              +---------#+                       #              #######.......|
            #                        #              #     +---#---+                        #                        #              #     +---#---+
            #  +-----------+         #     +--------#+        #                            #  +-----------+         #     +--------#+        #    
            ####...........##############  |.........|        #                            ####...........##############  |.........|        #    
               |...........|            #  |.........|        #                               |...........|            #  |.........|        #    
               +-----------+            ####.........|        #                               +-----------+            ####.........|        #    
                                           +----#----+        #                                                           +----#----+        #    
                                                #    +--------#--+                                                             #    +--------#--+ 
     +---------------------------------+        #    |...........|                  +---------------------------------+        #    |...........| 
     |.................................|        ######...........####################.................................|        ######...........| 
     |.................................|        #    |...........|                  |.................................|        #    |...........| 
     |......+---------------+..........|        #    |...........|                  |......+---------------+..........|        #    |...........| 
     |......|               |..........##########    +-----------+                  |......|               |..........##########    +-----------+ 
     |......|               |..........|                                            |......|               |..........|                           
     |......|               |..........|                    #########################......+---------------+..........|                           
     |......|               |..........######################                       |.................................|                           
     +------+               +----------+                                            +---------------------------------+                           
