####+----------------------#------------------------------+ 
   #......................................................| 
   +------------------------------------#---------------+.| 
##############################################          |.| 
#          +----+                  #         ############.##
##         |....|                  #                    +-+ 
 #         |....+------------------#--+                     
 #         |..........................|                     
 #         +----+..+------+--------+..|                     
 #         |..............|...........|                     
##         |...+----------+------+..+-+                     
#          +#-+.......................|                     
#           ###...........+...........+                     
#           # +-----------+---------+#+                     
######################################                      
