#                 ############  
# +---------------#---------+#  
###.........................##  
  |.........................|   
  |.........................|   
  +---------------#---------+   
                  #             
