  +----------+
  |..........|
  |..........|
  +-#--------+
    #         
    #         
    #         
  +-#--------+
  |..........|
  |..........|
  +----------+
