  +----------+                                                                 
  |..........|                 +---------+                                     
  |..........####              |.........|                +-------+            
  |..........|                 +-----#---+                |.......|            
  +---------#+                       #              #######.......|            
            #                        #              #     +---#---+            
            #  +-----------+         #     +--------#+        #                
            ####...........##############  |.........|        #                
               |...........|            #  |.........|        #                
               +-----------+            ####.........|        #                
                                           +----#----+        #                
                                                #    +--------#--+             
     +---------------------------------+        #    |...........|             
     |.................................|        ######...........|             
     |.................................|        #    |...........|             
     |......+---------------+..........|        #    |...........|             
     |......|               |..........##########    +-----------+             
     |......|               |..........|                                       
     |......|               |..........|                                       
     |......|               |..........|                                       
     +------+               +----------+                                       
